%%%%%%%%%%%%%%%%%%%%%%%%%%%%%%%%%%%%
%                                 P%
% %%%%%%%%%%%%..%%%%% %%% %%%%%%%% %
% %%   %   .      %%% %%%   %% ... %
% %% % % % . %..% %%%%%%%%% %% %%%%%
% %% % % % . %    %%     %% %% ... %
% %% % % % . % %%%%  ...    %%%%%% %
% %  % % %   %    %% %%%%%%%%  ... % 
% %% % % %..%%%%% %%        %% %%%%%
% %% %   %.       %%%%%%%%% %% ... %
%    %%%%%. %%%%%%%      %% %%%%%% %
%%%%%%      %       %%%% %% %  ... %
%      %%%.%% %%%%% %    %% %% %%%%%
% %%%%%%      %       %%%%% %%     %
%        %%%%%% %%%%%%%%%%% %%  %% %
%%%%%%%%%%                  %%%%%% %
%.         %%%%%%%%%%%%%%%% ...... %
%%%%%%%%%%%%%%%%%%%%%%%%%%%%%%%%%%%%
