%%%%%%%%%%%%%%%%%%%%%%%%%%%%%%%%%%%%
%                                 P%
% %%%%%%%...%%..%%%%% %%% %%%%%%%% %
% %%   %   .      %%% %%%   %% ... %
% %% % % . . %..% %%%%%%%%% %% ..%%%
% %% % % . . %    %%     %% %% ... %
% %% % % . . . %%%%  ...    %%..%% %
% %  % % .   .    .  .%%%%%%%  ... % 
% %% % % ...%%%%% %         %% ..%%%
% %% %   ..       .  .%%%%% %% ... %
%    %%%%.. %%%%%%%      %% %%%%.. %
%%%%%%      %       .%%% %% %  ... %
%      %%%.%% %%%%% .    %% %% ..%%%
% ..%%%%      .       %%%%% %%     %
%        %%%%%% ..%%%%%%%.. ..  .% %
%%%%%%%%%%                  %%%%%% %
%.         %%%%%%%%%%%%%%.. ...... %
%%%%%%%%%%%%%%%%%%%%%%%%%%%%%%%%%%%%
