%%%%%%%%%%%%%%%%%%%%%%%%%%%%%%%%%%%%
%                                 P%
% %%%%%%%...%%..%%%%% %%% %%%%%%%% %
% %%   %   .      %%% %%%   %% ... %
% %% % % . . %..% %%%%%%%%% %% ..%%%
% %% % % . . %    %%     %% %% ... %
% %% % % . . % %%%%  ...    %%..%% %
% %  % % .   %    %  %%%%%%%%  ... % 
% %% % % ...%%%%% %         %% ..%%%
% %% %   ..       .  %%%%%% %% ... %
%    %%%%.. %%%%%%%      %% %%%%.. %
%%%%%%      %       %%%% %% %  ... %
%      %%%.%% %%%%% %    %% %% ..%%%
% ..%%%%      .       %%%%% %%     %
%        %%%%%% ..%%%%%%%.. ..  .% %
%%%%%%%%%%                  %%%%%% %
%.         %%%%%%%%%%%%%%.. ...... %
%%%%%%%%%%%%%%%%%%%%%%%%%%%%%%%%%%%%
