%%%%%%%%%%%%%%%%%%%%%%%%%%%%%%%%%%%%
%                                 P%
% %%%%%%....%%..%%%%% %%% %%%%%%%% %
% %%   %   .      %%% %%%   %% ... %
% %% % % . . %..% %%%%%%%%% %% ..%%%
% %% % % . . %    %%     %% %% ... %
% %% % % . . . %%%%  ...    %%..%% %
% %  % % .   .    .  .%%%%%%%  ... % 
% %% % % ...%%%%% %         %% ..%%%
% %% %   ..       .  .%%%%% %% ... %
%    ...... %%%%%%%      %% %%%%.. %
%%....      %       .%%% %% %  ... %
%      %%%.%% %%%%% .    %% %% ..%%%
% ....%%      .       %%%%% %%     %
%        %%%%%% ..%%%%%%%.. ..  .% %
%...%%%%%%                  %%%%%% %
%.         %%%%%%%%%%%%%%.. ...... %
%%%%%%%%%%%%%%%%%%%%%%%%%%%%%%%%%%%%
